###########
#....#....#
#....#....d
##..##....#
#....#....#
#.........#
#.........#
#....#....#
###########