###########
#....#....#
#....#....#
#....##..##
#....#....#
#.........#
#.........#
#....#....#
###########
GHOST 3 2
MOLD 3 6